transaction_id,user_id,bank_timestamp,local_timestamp,location,ip_address,device_id,network_type,type,amount,account_id,balance_before,granted,balance_after,merchant_name,recipient_id,recipient_bank,behavior_type,is_hijacked,fraud_label
TXN-1619b49d9f,USER-729a9c67,2025-04-28T16:22:39+00:00,2025-04-28T12:22:39-04:00,"New York, USA",73.123.45.67,iPhone-12,Wi-Fi,Transfer Out,5000.0,ACC-90316bec,55310.0,True,50310.0,,ACC-12345678,Bank of America,Ponzi Scheme,0,1
TXN-934f0854ae,USER-729a9c67,2025-04-28T18:22:39+00:00,2025-04-28T14:22:39-04:00,"New York, USA",73.123.45.67,iPhone-12,Wi-Fi,Transfer Out,5000.0,ACC-90316bec,50310.0,True,45310.0,,ACC-12345678,Bank of America,Ponzi Scheme,0,1
TXN-f30aaf6f23,USER-729a9c67,2025-04-28T20:32:39+00:00,2025-04-28T16:32:39-04:00,"New York, USA",73.123.45.67,iPhone-12,Wi-Fi,Transfer Out,5000.0,ACC-90316bec,45310.0,True,40310.0,,ACC-12345678,Bank of America,Ponzi Scheme,0,1
TXN-e1a35097d4,USER-65589024,2025-04-28T20:57:39+00:00,2025-04-28T16:57:39-04:00,"New York, USA",73.123.45.67,iPhone-13,Wi-Fi,Purchase,125.75,ACC-94097351,2074.0,True,1948.25,Amazon,,,Everyday Spender,0,0
TXN-1f292dbabc,USER-65589024,2025-04-28T21:27:39+00:00,2025-04-28T17:27:39-04:00,"New York, USA",73.123.45.67,iPhone-13,Wi-Fi,Purchase,150.75,ACC-94097351,1948.25,True,1797.5,Amazon,,,Everyday Spender,0,0
TXN-266ba5a26e,USER-65589024,2025-04-28T21:57:39+00:00,2025-04-28T17:57:39-04:00,"New York, USA",73.123.45.67,iPhone-13,Wi-Fi,Purchase,35.75,ACC-94097351,1797.5,True,1761.75,Starbucks,,,Everyday Spender,0,0
TXN-f30d42376d,USER-65589024,2025-04-28T22:27:39+00:00,2025-04-28T18:27:39-04:00,"New York, USA",73.123.45.67,iPhone-13,Wi-Fi,Purchase,35.75,ACC-94097351,1761.75,True,1726.0,Amazon,,,Everyday Spender,0,0
